5 8  255, 165, 0;50, 205, 50;255, 248, 220;128, 0, 0
5 8  194, 10, 51;255, 127, 51;108, 89, 83;157, 242, 121
5 8  229, 178, 0;255, 0, 51;127, 255, 13;0, 38, 115
5 8  229, 247, 242;194, 0, 61;0, 126, 42;0, 255, 255
5 8  223, 218, 195;86, 182, 38;255, 229, 178;13, 255, 229
